



.______        ______     ______   .___  ___.  __ 
|   _  \      /  __  \   /  __  \  |   \/   | /_ |
|  |_)  |    |  |  |  | |  |  |  | |  \  /  |  | |
|      /     |  |  |  | |  |  |  | |  |\/|  |  | |
|  |\  \----.|  `--'  | |  `--'  | |  |  |  |  | |
| _| `._____| \______/   \______/  |__|  |__|  |_|



The dwarves are playing hide & seek. Find them all!




