







.______        ______     ______   .___  ___.  ___  
|   _  \      /  __  \   /  __  \  |   \/   | |__ \ 
|  |_)  |    |  |  |  | |  |  |  | |  \  /  |    ) |
|      /     |  |  |  | |  |  |  | |  |\/|  |   / / 
|  |\  \----.|  `--'  | |  `--'  | |  |  |  |  / /_ 
| _| `._____| \______/   \______/  |__|  |__| |____|









Nicky wants to meet her clone...
