



  _____   ____   ____  __  __   __ 
 |  __ \ / __ \ / __ \|  \/  | /_ |
 | |__) | |  | | |  | | \  / |  | |
 |  _  /| |  | | |  | | |\/| |  | |
 | | \ \| |__| | |__| | |  | |  | |
 |_|  \_\\____/ \____/|_|  |_|  |_|
                                   
                                   


The dwarves are playing hide & seek. Find them all!




