




  _____   ____   ____  __  __   _____ 
 |  __ \ / __ \ / __ \|  \/  | | ____|
 | |__) | |  | | |  | | \  / | | |__  
 |  _  /| |  | | |  | | |\/| | |___ \ 
 | | \ \| |__| | |__| | |  | |  ___) |
 |_|  \_\\____/ \____/|_|  |_| |____/ 
                                      
                                      


Maybe you got used with the "Secret:" pattern... Can you find it ?