




  _____   ____   ____  __  __     __  
 |  __ \ / __ \ / __ \|  \/  |   / /  
 | |__) | |  | | |  | | \  / |  / /_  
 |  _  /| |  | | |  | | |\/| | | '_ \ 
 | | \ \| |__| | |__| | |  | | | (_) |
 |_|  \_\\____/ \____/|_|  |_|  \___/ 
                                      


Find some info for the 4 friends...


