




  _____   ____   ____  __  __   ______ 
 |  __ \ / __ \ / __ \|  \/  | |____  |
 | |__) | |  | | |  | | \  / |     / / 
 |  _  /| |  | | |  | | |\/| |    / /  
 | | \ \| |__| | |__| | |  | |   / /   
 |_|  \_\\____/ \____/|_|  |_|  /_/    
                                       


Can you read me ...?


