




  _____   ____   ____  __  __   ___  
 |  __ \ / __ \ / __ \|  \/  | |__ \ 
 | |__) | |  | | |  | | \  / |    ) |
 |  _  /| |  | | |  | | |\/| |   / / 
 | | \ \| |__| | |__| | |  | |  / /_ 
 |_|  \_\\____/ \____/|_|  |_| |____|
                                     




Nicky wants to meet her clone...
