




  _____   ____   ____  __  __   _  _   
 |  __ \ / __ \ / __ \|  \/  | | || |  
 | |__) | |  | | |  | | \  / | | || |_ 
 |  _  /| |  | | |  | | |\/| | |__   _|
 | | \ \| |__| | |__| | |  | |    | |  
 |_|  \_\\____/ \____/|_|  |_|    |_|  
                                       


                                    
I will take you to a place far far away... Follow "next"



