




  _____   ____   ____  __  __    ___  
 |  __ \ / __ \ / __ \|  \/  |  / _ \ 
 | |__) | |  | | |  | | \  / | | (_) |
 |  _  /| |  | | |  | | |\/| |  > _ < 
 | | \ \| |__| | |__| | |  | | | (_) |
 |_|  \_\\____/ \____/|_|  |_|  \___/ 
                                      
                                      