




  _____   ____   ____  __  __    ___  
 |  __ \ / __ \ / __ \|  \/  |  / _ \ 
 | |__) | |  | | |  | | \  / | | (_) |
 |  _  /| |  | | |  | | |\/| |  \__, |
 | | \ \| |__| | |__| | |  | |    / / 
 |_|  \_\\____/ \____/|_|  |_|   /_/  
                                      
                                      