



  _____   ____   ____  __  __   ____  
 |  __ \ / __ \ / __ \|  \/  | |___ \ 
 | |__) | |  | | |  | | \  / |   __) |
 |  _  /| |  | | |  | | |\/| |  |__ < 
 | | \ \| |__| | |__| | |  | |  ___) |
 |_|  \_\\____/ \____/|_|  |_| |____/ 
                                      
                                      




The bomb is about to explode in 20secs. Deactivate it. Be fast!




